11111111111111111111
10000000000000000001
10000001111100000001
10000001000100000001
10000001000100000001
10000001111100000001
10000000000000000001
10000011111110000001
10000000000000000001
10000000000000000001
10000000000000000001
10000000000000000001
10000000000000000001
10000000000000000001
10000000000000000001
10000000000000000001
10000011111111000001
10000000000000000001
10011100000000111001
10000000000000000001
11111111111111111111